ModbusRTUMasterError	KEYWORD1		
MODBUS_RTU_MASTER_SUCCESS	LITERAL1		
MODBUS_RTU_MASTER_INVALID_ID	LITERAL1		
MODBUS_RTU_MASTER_INVALID_BUFFER	LITERAL1		
MODBUS_RTU_MASTER_INVALID_QUANTITY	LITERAL1		
MODBUS_RTU_MASTER_RESPONSE_TIMEOUT	LITERAL1		
MODBUS_RTU_MASTER_FRAME_ERROR	LITERAL1		
MODBUS_RTU_MASTER_CRC_ERROR	LITERAL1		
MODBUS_RTU_MASTER_UNKNOWN_COMM_ERROR	LITERAL1		
MODBUS_RTU_MASTER_UNEXPECTED_ID	LITERAL1		
MODBUS_RTU_MASTER_EXCEPTION_RESPONSE	LITERAL1		
MODBUS_RTU_MASTER_UNEXPECTED_FUNCTION_CODE	LITERAL1		
MODBUS_RTU_MASTER_UNEXPECTED_LENGTH	LITERAL1		
MODBUS_RTU_MASTER_UNEXPECTED_BYTE_COUNT	LITERAL1		
MODBUS_RTU_MASTER_UNEXPECTED_ADDRESS	LITERAL1		
MODBUS_RTU_MASTER_UNEXPECTED_VALUE	LITERAL1		
MODBUS_RTU_MASTER_UNEXPECTED_QUANTITY	LITERAL1		
ModbusRTUMaster	KEYWORD1		
setTimeout	KEYWORD2		
begin	KEYWORD2		
readCoils	KEYWORD2		
readDiscreteInputs	KEYWORD2		
readHoldingRegisters	KEYWORD2		
readInputRegisters	KEYWORD2		
writeSingleCoil	KEYWORD2		
writeSingleHoldingRegister	KEYWORD2		
writeMultipleCoils	KEYWORD2		
writeMultipleHoldingRegisters	KEYWORD2		
getExceptionResponse	KEYWORD2		